####################
#__________________#
#__________________#
#_______#########__#
#_____m______#_____#
#____________#_____#
#____________#_____#
#____________#_____#
#__________________#
#___##########_____#
#__________________#
#________J_________#
#__________________#
#________#_________#
#________#_________#
#________#_________#
#___P____#_________#
#________#####_____#
#________#_________#
#________#_________#
#__________________#
####################
